#########
#       #
#       #
#       #
###-#####
#   #   #
#   #   #
#  P|   #
#   #   #
#########
