#########
#       #
#       #
#   t   #
###-##-##
#tll#  t#
#   #l  #
#  P|   #
#   #   #
#########
// Levers
2 5 N A
3 5 E A
5 6 W B
// Doors
3 4 A
6 4 A
4 7 B
// Torches
1 5 W
7 5 E
4 3 S
