#########
#       #
#       #
#   t   #
###-##-##
#tl #  t#
#   #l  #
#  P|   #
#   #   #
#########
// Levers
2 5 N
5 6 W
// Torches
1 5 W
7 5 E
4 3 S
